# # # # # # # # # # #
#                   #
#   @     .   $		#
#                   #
#                   #
# # # # # # # # # # #