# # # # # # # # #
#     .     $   #
#   @     !     #
#               #
#               #
# # # # # # # # #