# # # # # # # # # #
#                 #
#   @     .   $   #
#                 #
#                 #
# # # # # # # # # #